"filename", "language", "JavaScript", "JavaScript JSX", "XML", "PostCSS", "comment", "blank", "total"
"/Users/yinian/Desktop/sometheme-daisyUI/src/App.jsx", "JavaScript JSX", 0, 76, 0, 0, 3, 11, 90
"/Users/yinian/Desktop/sometheme-daisyUI/src/assets/react.svg", "XML", 0, 0, 1, 0, 0, 0, 1
"/Users/yinian/Desktop/sometheme-daisyUI/src/components/ContentRenderer.jsx", "JavaScript JSX", 0, 139, 0, 0, 1, 11, 151
"/Users/yinian/Desktop/sometheme-daisyUI/src/components/ProtectedRoute.jsx", "JavaScript JSX", 0, 9, 0, 0, 3, 4, 16
"/Users/yinian/Desktop/sometheme-daisyUI/src/components/dashboard/NodeList.jsx", "JavaScript JSX", 0, 95, 0, 0, 4, 8, 107
"/Users/yinian/Desktop/sometheme-daisyUI/src/components/dashboard/ResetButtom.jsx", "JavaScript JSX", 0, 54, 0, 0, 0, 7, 61
"/Users/yinian/Desktop/sometheme-daisyUI/src/components/dashboard/Subscriber.jsx", "JavaScript JSX", 0, 65, 0, 0, 0, 12, 77
"/Users/yinian/Desktop/sometheme-daisyUI/src/components/dashboard/SubscriptionButton.jsx", "JavaScript JSX", 0, 45, 0, 0, 0, 7, 52
"/Users/yinian/Desktop/sometheme-daisyUI/src/components/dashboard/SubscriptionInfo.jsx", "JavaScript JSX", 0, 92, 0, 0, 2, 11, 105
"/Users/yinian/Desktop/sometheme-daisyUI/src/components/dashboard/TrafficChart.jsx", "JavaScript JSX", 0, 120, 0, 0, 0, 9, 129
"/Users/yinian/Desktop/sometheme-daisyUI/src/components/dashboard/clientSchemas.jsx", "JavaScript JSX", 0, 122, 0, 0, 0, 13, 135
"/Users/yinian/Desktop/sometheme-daisyUI/src/components/home/AppDownload.jsx", "JavaScript JSX", 0, 57, 0, 0, 0, 5, 62
"/Users/yinian/Desktop/sometheme-daisyUI/src/components/home/NoticeCarousel.jsx", "JavaScript JSX", 0, 157, 0, 0, 0, 13, 170
"/Users/yinian/Desktop/sometheme-daisyUI/src/components/home/StatAlerts.jsx", "JavaScript JSX", 0, 59, 0, 0, 0, 5, 64
"/Users/yinian/Desktop/sometheme-daisyUI/src/components/home/TelegramHero.jsx", "JavaScript JSX", 0, 101, 0, 0, 2, 4, 107
"/Users/yinian/Desktop/sometheme-daisyUI/src/components/layout/Docker.jsx", "JavaScript JSX", 0, 52, 0, 0, 1, 11, 64
"/Users/yinian/Desktop/sometheme-daisyUI/src/components/layout/Infobar.jsx", "JavaScript JSX", 0, 105, 0, 0, 8, 15, 128
"/Users/yinian/Desktop/sometheme-daisyUI/src/components/layout/RightPanelToggleButtons.jsx", "JavaScript JSX", 0, 21, 0, 0, 0, 4, 25
"/Users/yinian/Desktop/sometheme-daisyUI/src/components/layout/RightPanelWrapper.jsx", "JavaScript JSX", 0, 23, 0, 0, 0, 4, 27
"/Users/yinian/Desktop/sometheme-daisyUI/src/components/layout/Settingsbar.jsx", "JavaScript JSX", 0, 91, 0, 0, 4, 15, 110
"/Users/yinian/Desktop/sometheme-daisyUI/src/components/layout/Sidebar.jsx", "JavaScript JSX", 0, 41, 0, 0, 1, 5, 47
"/Users/yinian/Desktop/sometheme-daisyUI/src/components/layout/Topbar.jsx", "JavaScript JSX", 0, 52, 0, 0, 0, 9, 61
"/Users/yinian/Desktop/sometheme-daisyUI/src/components/layout/UserControls.jsx", "JavaScript JSX", 0, 46, 0, 0, 2, 7, 55
"/Users/yinian/Desktop/sometheme-daisyUI/src/components/modals/CancelOrderButton.jsx", "JavaScript JSX", 0, 37, 0, 0, 0, 7, 44
"/Users/yinian/Desktop/sometheme-daisyUI/src/components/modals/CloseTicketModal.jsx", "JavaScript JSX", 0, 65, 0, 0, 1, 9, 75
"/Users/yinian/Desktop/sometheme-daisyUI/src/components/modals/CreatTicketButton.jsx", "JavaScript JSX", 0, 149, 0, 0, 1, 17, 167
"/Users/yinian/Desktop/sometheme-daisyUI/src/components/modals/LogoutButton.jsx", "JavaScript JSX", 0, 51, 0, 0, 1, 7, 59
"/Users/yinian/Desktop/sometheme-daisyUI/src/components/modals/Modal.jsx", "JavaScript JSX", 0, 24, 0, 0, 0, 5, 29
"/Users/yinian/Desktop/sometheme-daisyUI/src/components/modals/ResetPasswordButton.jsx", "JavaScript JSX", 0, 117, 0, 0, 0, 21, 138
"/Users/yinian/Desktop/sometheme-daisyUI/src/components/modals/TransferButton.jsx", "JavaScript JSX", 0, 85, 0, 0, 4, 12, 101
"/Users/yinian/Desktop/sometheme-daisyUI/src/components/modals/WithdrawButton.jsx", "JavaScript JSX", 0, 94, 0, 0, 0, 12, 106
"/Users/yinian/Desktop/sometheme-daisyUI/src/components/order/OrderDetail.jsx", "JavaScript JSX", 0, 262, 0, 0, 11, 23, 296
"/Users/yinian/Desktop/sometheme-daisyUI/src/components/order/OrderList.jsx", "JavaScript JSX", 0, 209, 0, 0, 0, 27, 236
"/Users/yinian/Desktop/sometheme-daisyUI/src/components/order/PaymentQRCode.jsx", "JavaScript JSX", 0, 30, 0, 0, 0, 6, 36
"/Users/yinian/Desktop/sometheme-daisyUI/src/components/plan/PlanDetail.jsx", "JavaScript JSX", 0, 212, 0, 0, 0, 8, 220
"/Users/yinian/Desktop/sometheme-daisyUI/src/components/plan/PlanList.jsx", "JavaScript JSX", 0, 101, 0, 0, 3, 5, 109
"/Users/yinian/Desktop/sometheme-daisyUI/src/components/ticket/TicketDetail.jsx", "JavaScript JSX", 0, 163, 0, 0, 8, 19, 190
"/Users/yinian/Desktop/sometheme-daisyUI/src/components/ui/StatusMessage.jsx", "JavaScript JSX", 0, 34, 0, 0, 0, 5, 39
"/Users/yinian/Desktop/sometheme-daisyUI/src/config/runtimeConfig.js", "JavaScript", 17, 0, 0, 0, 0, 4, 21
"/Users/yinian/Desktop/sometheme-daisyUI/src/hooks/useCancelOrder.jsx", "JavaScript JSX", 0, 26, 0, 0, 1, 5, 32
"/Users/yinian/Desktop/sometheme-daisyUI/src/hooks/usePaymentPolling.jsx", "JavaScript JSX", 0, 70, 0, 0, 3, 13, 86
"/Users/yinian/Desktop/sometheme-daisyUI/src/hooks/usePollTicketDetail.jsx", "JavaScript JSX", 0, 25, 0, 0, 4, 8, 37
"/Users/yinian/Desktop/sometheme-daisyUI/src/hooks/useThemeInit.jsx", "JavaScript JSX", 0, 22, 0, 0, 1, 6, 29
"/Users/yinian/Desktop/sometheme-daisyUI/src/hooks/useViewportHeight.jsx", "JavaScript JSX", 0, 18, 0, 0, 1, 7, 26
"/Users/yinian/Desktop/sometheme-daisyUI/src/index.css", "PostCSS", 0, 0, 0, 15, 1, 3, 19
"/Users/yinian/Desktop/sometheme-daisyUI/src/layouts/AppLayout.jsx", "JavaScript JSX", 0, 119, 0, 0, 8, 17, 144
"/Users/yinian/Desktop/sometheme-daisyUI/src/layouts/LoginLayout.jsx", "JavaScript JSX", 0, 19, 0, 0, 2, 5, 26
"/Users/yinian/Desktop/sometheme-daisyUI/src/main.jsx", "JavaScript JSX", 0, 26, 0, 0, 0, 4, 30
"/Users/yinian/Desktop/sometheme-daisyUI/src/pages/Dashboard.jsx", "JavaScript JSX", 0, 48, 0, 0, 4, 7, 59
"/Users/yinian/Desktop/sometheme-daisyUI/src/pages/Home.jsx", "JavaScript JSX", 0, 65, 0, 0, 0, 11, 76
"/Users/yinian/Desktop/sometheme-daisyUI/src/pages/Knowledge.jsx", "JavaScript JSX", 0, 140, 0, 0, 4, 14, 158
"/Users/yinian/Desktop/sometheme-daisyUI/src/pages/Login.jsx", "JavaScript JSX", 0, 258, 0, 0, 23, 25, 306
"/Users/yinian/Desktop/sometheme-daisyUI/src/pages/NotFound.jsx", "JavaScript JSX", 0, 8, 0, 0, 0, 2, 10
"/Users/yinian/Desktop/sometheme-daisyUI/src/pages/Order.jsx", "JavaScript JSX", 0, 13, 0, 0, 0, 3, 16
"/Users/yinian/Desktop/sometheme-daisyUI/src/pages/Plan.jsx", "JavaScript JSX", 0, 144, 0, 0, 0, 18, 162
"/Users/yinian/Desktop/sometheme-daisyUI/src/pages/Ticket.jsx", "JavaScript JSX", 0, 165, 0, 0, 8, 13, 186
"/Users/yinian/Desktop/sometheme-daisyUI/src/pages/Wallet.jsx", "JavaScript JSX", 0, 132, 0, 0, 0, 14, 146
"/Users/yinian/Desktop/sometheme-daisyUI/src/redux/slices/inviteSlice.js", "JavaScript", 78, 0, 0, 0, 3, 6, 87
"/Users/yinian/Desktop/sometheme-daisyUI/src/redux/slices/knowledgeSlice.js", "JavaScript", 81, 0, 0, 0, 2, 11, 94
"/Users/yinian/Desktop/sometheme-daisyUI/src/redux/slices/orderSlice.js", "JavaScript", 252, 0, 0, 0, 17, 17, 286
"/Users/yinian/Desktop/sometheme-daisyUI/src/redux/slices/passportSlice.js", "JavaScript", 302, 0, 0, 0, 16, 15, 333
"/Users/yinian/Desktop/sometheme-daisyUI/src/redux/slices/planSlice.js", "JavaScript", 94, 0, 0, 0, 4, 8, 106
"/Users/yinian/Desktop/sometheme-daisyUI/src/redux/slices/ticketSlice.js", "JavaScript", 264, 0, 0, 0, 15, 29, 308
"/Users/yinian/Desktop/sometheme-daisyUI/src/redux/slices/userSlice.js", "JavaScript", 363, 0, 0, 0, 23, 30, 416
"/Users/yinian/Desktop/sometheme-daisyUI/src/redux/store.js", "JavaScript", 20, 0, 0, 0, 0, 3, 23
"/Users/yinian/Desktop/sometheme-daisyUI/src/utils/api.js", "JavaScript", 32, 0, 0, 0, 2, 5, 39
"Total", "-", 1503, 4553, 1, 15, 202, 676, 6950